eeeeeeeeeeeeeeeeeeeeeeeee
e    G   BG  ...........e
e B  GBbbbb  ...........e
e     bPB    ...........e
e G    bb..   .....G....e
e.......................e
e....................B..e
e........G.....B........e
e..............BG..G....e
e..G.B.........BB....B..e
e.......B.G.............e
e....B..........G.......e
e.........B.............e
e..B......B.............e
e..G......G.....B..B....e
e.......D.......B..B....e
e..................G....e
eeeeeeeeeeeeeeeeeeeeeeeee