eeeeeeeeeeeeeeeeeeeeeeeee
e              ......B..D
e              .BB......e
e   B          .B.......e
ebbbbbbbbbbbbb .........e
eE             .B.......e
e              .B.B.....e
e              .........e
ebbbbbbbbbbbbb ...B.....e
eE             .........e
e              .........e
e  G           .........e
ebbbbbbbbbbbbb .........e
eE             .........e
e  B           .........e
e  G           ....P....e
eeeeeeeeeeeeeeeeeeeeeeeee