eeeeeeeeeeeeeeeeeeeeeeeeee
e                        e
e                        e
e   P                    e
e                        e
e            B           e
e            .           e
e                        e
e                        e
e                        e
e                        e
eE                       e
eeeeeeeeeeeeeeeeeeeeeeDeee