eeeeeeeeeeeeeeeeeeeeeeeeeeeeeeeeeeee
e..................................e
e..BBBBBBBG..BBBBBBBBE   BBBBBBBBBBe
e..BBGGGGBB.BBBBBGGGBBBGBBBGGGGBBBBe
e..BBBBBBBB.BBBBBGGGGGGbbbbBBBBBBBBe
e..BBBBBBBB.BBBBBBGGGBBBBGGGGGBBBBBe
e..BBBBBBBbbbbbBBBBBGBBBBBBBBBBBBBBe
e..BBGGBBBBBBBBBBBBBGBBBBBBBGGGGBBBe
e..BBBBBBGGGGGGBBBBBGBBBBBBBGGGGGGGe
e..BBBBBGGGBBBBBBBBBBGGGGGGBBBBBBBBe
e..BBBBBGGGGGBBBBBBBBBBBBGBBBBBBBbbe
e    BBBGBBBGBBBBBBBBBBBBGBB  E   De
e    GGGGBGGGGGBBGGGGGGGGGBB      .e
e   .bbbbbbbb.......bbbbbbbb....bb.e
e                                  e
e                                  e
e                                  e
e                                  e
e                                  e
e                P                 e
eeeeeeeeeeeeeeeeeeeeeeeeeeeeeeeeeeee